border_size=1
usage=map

Gg          , Gg          , Gg          , Gg          , Ggf         , Ggf         , Ggf         , Gg          , Gg          , Gg          , Rr          , Gg          , Gg          , Ggf         , Gg          , Ggf         , Gs^Fp       , Gg          , Gs^Fp       , Gs^Fp       , Gs^Fp       , Gs^Fp       
Gg          , Gg          , Gg          , Gg          , Ggf         , Dd^Dr       , Dd^Do       , Ggf         , Gg          , Gg          , Gg          , Rr          , Gg          , Gg          , Gg          , Hh          , Hh          , Gg          , Gg          , Gs^Fp       , Gs^Fp       , Gs^Fp       
Gg          , Gg          , Gg          , Gg          , Ggf         , Dd^Dc       , Ggf         , Ggf         , Gg          , Gg          , Rr          , Rr          , Ce          , 2 Ke        , Ce          , Hh          , Gs^Fp       , Gg          , Gg          , Gg          , Hh          , Hh          
Re^Gvs      , Re^Gvs      , Gg^Ve       , Gg          , Gg          , Ggf         , Gg          , Gg          , Gg          , Rr          , Gg          , Hh          , Hh          , Ce          , Hh          , Hh          , Gs^Fp       , Gg^Ve       , Gg          , Gg          , Hh          , Hh          
Re^Gvs      , Re^Gvs      , Gg^Wm       , Gg          , Ggf         , Ggf         , Ggf         , Gg          , Gg          , Rr          , Hh          , Hh          , Hh          , Hh          , Gs^Fp       , Hh          , Ggf         , Ggf         , Ggf         , Gg          , Gg          , Hh          
Re^Gvs      , Re^Gvs      , Gg          , Ggf         , Dd^Do       , Dd^Dc       , Ggf         , Gs^Fp       , Hh          , Rr          , Rr          , Gg          , Gs^Fp       , Gs^Fp       , Gs^Fp       , Gg          , Ggf         , Dd          , Dd^Dc       , Ggf         , Gg          , Gs^Fp       
Re^Gvs      , Re^Gvs      , Gs^Fp       , Ggf         , Ggf         , Dd          , Ggf         , Gs^Fp       , Gs^Fp       , Hh          , Rr          , Hh          , Hh          , Gg          , Gg          , Gg          , Ggf         , Dd^Do       , Ggf         , Ggf         , Gg          , Gg          
Gs^Fp       , Gs^Fp       , Gs^Fp       , Gs^Fp       , Gg          , Ggf         , Gg          , Gs^Fp       , Gg          , Hh          , Rr          , Gg          , Ggf         , Ggf         , Ggf         , Gg          , Gg          , Ggf         , Gg          , Gg          , Gg          , Gg          
Gs^Fp       , Gs^Fp       , Gs^Fp       , Gs^Fp       , Gg          , Gg^Ve       , Gg          , Gg          , Gg          , Gg          , Rr          , Gg          , Ggf         , Hd          , Dd^Do       , Ggf         , Gg          , Gg          , Gg^Ve       , Gg          , Gg          , Gg          
Gs^Fp       , Gs^Fp       , Gs^Fp       , Gs^Fp       , Gs^Fp       , Gg          , Gs^Fp       , Gg          , Gg          , Gg          , Gg          , Rr          , Ggf         , Dd^Dr       , Ggf         , Ggf         , Gg          , Gg^Wm       , Re^Gvs      , Re^Gvs      , Re^Gvs      , Gg          
Gs^Fp       , Gs^Fp       , Gs^Fp       , Gg          , Ggf         , Ggf         , Ggf         , Gg          , Gg          , Gg          , Gg          , Rr          , Gg          , Ggf         , Gg          , Gg          , Re^Gvs      , Re^Gvs      , Re^Gvs      , Re^Gvs      , Re^Gvs      , Re^Gvs      
Ww          , Ww          , Chw         , Ggf         , Dd^Dr       , Dd^Do       , Ggf         , Gg          , Hh          , Hh          , Gg          , Rr          , Rr          , Gg          , Hh          , Re^Gvs      , Re^Gvs      , Re^Gvs      , Re^Gvs      , Re^Gvs      , Re^Gvs      , Re^Gvs      
Ggf         , Ww          , Chw         , Chw         , Ww          , Dd^Dc       , Gg^Ve       , Gg          , Hh          , Hh          , Hh          , Hh          , Rr          , Hh          , Hh          , Hh          , Hh          , Re^Gvs      , Re^Gvs      , Re^Gvs      , Gg          , Gg          
Ggf         , 3 Khr       , Ggf         , Ggf         , Ww          , Ww          , Dd          , Ggf         , Ggf         , Hh          , Gg          , Hh          , Rr          , Hh          , Ggf         , Ggf         , Ggf         , Gg          , Gg          , Ggf         , Gg          , Gg          
Ggf         , Ggf         , Ggf         , Ggf         , Ww          , Ww          , Dd^Dc       , Dd^Do       , Ggf         , Gg          , Gg          , Rr          , Gg          , Gg          , Ggf         , Dd^Do       , Dd^Dc       , Ggf         , Ggf         , Gg          , Gg          , Gg          
Ggf         , Gg^Ve       , Ggf         , Ww          , Ww          , Ww          , Ww          , Ggf         , Gg          , Gg          , Gg          , Rr          , Gg          , Gg          , Ggf         , Dd          , Ggf         , Ggf         , Gg          , Gg          , Gg          , Gg          
Ww          , Ggf         , Ww^Bw\      , Ww          , Ww          , Ww          , Gg          , Gg          , Gg          , Gg          , Gg          , Rr          , Gg^Ve       , Gg          , Ce          , Ggf         , Ce          , Ce          , Ggf         , Gg          , Gg          , Gg          
Ww          , Ww          , Gs^Fp       , Gg          , Gg          , Gg          , Gg          , Gs^Fp       , Gs^Fp       , Gs^Fp       , Gs^Fp       , Rr          , Rr          , Gg          , Gg          , 1 Ke        , Ggf         , Ggf         , Dd^Dc       , Ggf         , Gg          , Gg          
Gs^Fp       , Gs^Fp       , Ggf         , Gs^Fp       , Gs^Fp       , Gs^Fp       , Gg          , Gs^Fp       , Gg          , Gs^Fp       , Gg          , Gg          , Ggf         , Rr          , Rr          , Gg          , Ggf         , Dd^Dr       , Dd^Do       , Ggf         , Gg          , Gg          
Ggf         , Ggf         , Dd^Do       , Ggf         , Gs^Fp       , Gg          , Gg^Ve       , Gg          , Gg          , Gg          , Ggf         , Ggf         , Dd^Dc       , Ggf         , Gg          , Rr          , Rr          , Ggf         , Ggf         , Ggf         , Gg          , Gg          
Ggf         , Dd^Dr       , Dd          , Ggf         , Gs^Fp       , Gg^Wm       , Re^Gvs      , Re^Gvs      , Re^Gvs      , Gg          , Ggf         , Dd^Do       , Dd^Dr       , Ggf         , Gg          , Gg          , Rr          , Gg          , Gg          , Gg          , Gg          , Gg          
Gg          , Ggf         , Ggf         , Ggf         , Gs^Fp       , Gs^Fp       , Gs^Fp       , Re^Gvs      , Gs^Fp       , Gs^Fp       , Gs^Fp       , Ggf         , Ggf         , Ggf         , Gg          , Gg          , Gg          , Rr          , Rr          , Gg          , Gg          , Gg          
