border_size=1
usage=map

Re^Gvs      , Re^Gvs      , Re^Gvs      , Re^Gvs      , Gg          , Gg          , Gs^Fp       , Hh          , Hh          , Hh          , Gs^Fp       , Gs^Fp       , Gs^Fp       , Hh          , Hh          , Hh          , Gs^Fp       , Gs^Fp       , Gs^Fp       , Hh          , Hh          , Hh          , Gs^Fp       , Hh          , Hh          , Gg          , Gs^Fp       , Gs^Fp       , Hh          , Hh          , Hh          , Hh          , Gs^Fp       
Re^Gvs      , Re^Gvs      , Gg^Ve       , Gg          , Gg          , Gg          , Gs^Fp       , Gs^Fp       , Gs^Fp       , Gs^Fp       , Gs^Fp       , Gs^Fp       , Hh          , Hh          , Gs^Fp       , Hh          , Ww          , Hh          , Gs^Fp       , Gs^Fp       , Gs^Fp       , Gs^Fp       , Gg          , Gg          , Gg          , Gg          , Re^Gvs      , Gg          , Gg          , Hh          , Gg          , Gs^Fp       , Gs^Fp       
Gg          , Gg          , Gg          , Gg          , Gg          , Gs^Fp       , Gg          , Gg          , Gg          , Gg          , Gg          , Gs^Fp       , Gs^Fp       , Gs^Fp       , Ww          , Ww          , Ww          , Ww          , Ww          , Gs^Fp       , Gg          , Gs^Fp       , Gg^Wm       , Gg^Ve       , Re^Gvs      , Re^Gvs      , Re^Gvs      , Re^Gvs      , Re^Gvs      , Gs^Fp       , Gg          , Gg^Ve       , Gs^Fp       
Gg          , Gg          , Hh          , Hh          , Gg^Wm       , Hh          , Gg          , Gg^Ve       , Gg          , Gg          , Gg          , Gg          , Ww          , Ww          , Ww          , Ww          , Ww          , Ww          , Ww          , Ww          , Ww          , Gg          , Gg          , Re^Gvs      , Re^Gvs      , Re^Gvs      , Re^Gvs      , Re^Gvs      , Re^Gvs      , Re^Gvs      , Gs^Fp       , Gg          , Re          
Gg          , Gg          , Hh          , Hh          , Hh          , Hh          , Gg          , Gg          , Gg          , Gg          , Ww          , Ww          , Ww          , Ww          , Ww^Bw/      , Ce          , Ce          , Ce          , Ww^Bw\      , Ww          , Ww          , Ww          , Ww          , Gg          , Gg          , Re^Gvs      , Re^Gvs      , Re^Gvs      , Gg          , Gs^Fp       , Gs^Fp       , Re          , Gg          
Re          , Gg          , Gg          , Hh          , Gs^Fp       , Hh          , Gg          , Gg          , Ww          , Ww          , Ww          , Ww          , Ww^Bw/      , Ce          , Ce          , Ww          , Ww          , Ww          , Ce          , Ce          , Ww^Bw\      , Ww          , Ww          , Ww          , Ww          , Gg          , Gg          , Gg          , Gg          , Gs^Fp       , Gs^Fp       , Re          , Gs^Fp       
Gg          , Re          , Re          , Gg          , Gs^Fp       , Gs^Fp       , Ww          , Ww          , Ww          , Ww          , Ww^Bw/      , Ce          , Ce          , Ww          , Ww          , Ce          , Ce          , Ce          , Ww          , Ww          , Ce          , Ce          , Ww^Bw\      , Ww          , Ww          , Ww          , Ww          , Gg          , Re          , Re          , Re          , Re          , Gs^Fp       
Gg          , Re          , Gg          , Re          , Re          , Re          , Ww^Bw\      , Ww          , Ww          , Ce          , Ce          , Ww          , Ww          , Ce          , Ce          , Ww          , Ww          , Ww          , Ce          , Ce          , Ww          , Ww          , Ce          , Ce          , Ww          , Ww          , Ww^Bw/      , Re          , Gg          , Gs^Fp       , Gs^Fp       , Re          , Gs^Fp       
Gg          , Re          , Gg^Ve       , Gg          , Gg          , Gg          , Gg          , Ww^Bw\      , Ce          , Ww          , Ww          , Ce          , Ce          , Ww          , Ww          , Ce          , Ce          , Ce          , Ww          , Ww          , Ce          , Ce          , Ww          , Ww          , Ce          , Ww^Bw/      , Gg          , Gg          , Gg          , Gs^Fp       , Re          , Re          , Hh          
Gg          , Re          , Re          , Gg^Wm       , Re          , Gg          , Ww^Bw/      , Ww^Bw/      , Ce          , Ww^Bw\      , Ce          , Ww          , Ww          , Ce          , Ce          , Wwf         , Wwf         , Wwf         , Ce          , Ce          , Ww          , Ww          , Ce          , Ww^Bw/      , Ce          , Ww^Bw\      , Ww^Bw\      , Gg          , Gg          , Gg          , Re          , Gs^Fp       , Gg          
Gg          , Gg          , Hh          , Re          , Gg          , Re          , Ww          , Ww          , Ce          , Ww          , Ce          , Ww^Bw\      , Ce          , Wwf         , Wwf         , Ce          , Ce          , Ce          , Wwf         , Wwf         , Ce          , Ww^Bw/      , Ce          , Ww          , Ce          , Ww          , Ww          , Re          , Re          , Re          , Gg^Ve       , Gg          , Gg          
Hh          , Hh          , Gs^Fp       , Hh          , Gs^Fp       , Gg          , Ww          , Ww          , Ce          , Ww          , Ce          , Ww^Bw/      , Ce          , Wwf         , Ce          , Wwf         , Wwf         , Wwf         , Ce          , Wwf         , Ce          , Ww          , Ce          , Ww          , Ce          , Ww          , Ww          , Gg          , Gs^Fp       , Gg          , Gg          , Gg          , Gs^Fp       
Gs^Fp       , Hh          , Gs^Fp       , Hh          , Gs^Fp       , Gg          , Ww          , Ww          , Ce          , Ww          , Ce          , Ww          , 2 Ke        , Wwf         , Wwf         , Wwf         , 3 Ke        , Wwf         , Wwf         , Wwf         , 4 Ke        , Ww          , Ce          , Ww          , Ce          , Ww          , Ww          , Gs^Fp       , Gs^Fp       , Gg          , Gs^Fp       , Gs^Fp       , Hh          
Gg          , Gs^Fp       , Gg          , Gs^Fp       , Gg          , Gg          , Ww^Bw/      , Ww^Bw/      , Ce          , Ww          , Ce          , Ww          , Ce          , Wwf         , Ce          , Ce          , Wo          , Ce          , Ce          , Wwf         , Ce          , Ww          , Ce          , Ww          , Ce          , Ww^Bw\      , Ww^Bw\      , Gg          , Gs^Fp       , Gs^Fp       , Gs^Fp       , Hh          , Hh          
Re^Gvs      , Gg          , Gs^Fp       , Gg          , Re          , Re          , Ww          , Ww          , Ce          , Ww          , Ce          , Ww          , Ce          , Wwf         , Wwf         , Wwf         , Ce          , Wwf         , Wwf         , Wwf         , Ce          , Ww          , Ce          , Ww          , Ce          , Ww          , Ww          , Re          , Re          , Gg          , Gg          , Gs^Fp       , Hh          
Re^Gvs      , Gg^Wm       , Gg          , Gg          , Re          , Gg          , Ww          , Ww          , Ce          , Ww          , Ce          , Ww          , Ww          , Wwf         , Ce          , Ce          , Wwf         , Ce          , Ce          , Wwf         , Ww          , Ww          , Ce          , Ww          , Ce          , Ww          , Ww          , Gg          , Re          , Gg^Ve       , Gg          , Gs^Fp       , Hh          
Re^Gvs      , Gg^Ve       , Re          , Re          , Gg          , Gg          , Ww          , Ww          , Ce          , Ce          , Ww          , Ww          , Ce          , Ce          , Ww          , Wwf         , Ce          , Wwf         , Ww          , Ce          , Ce          , Ww          , Ww          , Ce          , Ce          , Ww          , Ww          , Gs^Fp       , Gs^Fp       , Re          , Gg          , Hh          , Hh          
Gg          , Gg          , Re          , Gs^Fp       , Gs^Fp       , Gg          , Ww^Bw/      , Ww^Bw/      , Ww          , Ww^Bw\      , Ce          , Ce          , Ww          , Ww          , Ce          , Ce          , Ww          , Ce          , Ce          , Ww          , Ww          , Ce          , Ce          , Ww^Bw/      , Ww          , Ww^Bw\      , Ww^Bw\      , Gs^Fp       , Gg          , Re          , Re          , Gg          , Gs^Fp       
Hh          , Gg          , Re          , Gg          , Re          , Re          , Gg          , Ww          , Ww          , Ww          , Ww          , Ww^Bw\      , Ce          , Ce          , Ww^Bw|      , Ww          , Ce          , Ww          , Ww^Bw|      , Ce          , Ce          , Ww^Bw/      , Ww          , Ww          , Ww          , Ww          , Gg          , Re          , Re          , Gg          , Re          , Gg          , Hh          
Hh          , Hh          , Re          , Gg          , Re          , Gg          , Gs^Fp       , Gs^Fp       , Gg          , Ww          , Ww          , Ww          , Ww          , Ww^Bw\      , Ce          , Ce          , Ww          , Ce          , Ce          , Ww^Bw/      , Ww          , Ww          , Ww          , Ww          , Gg          , Gs^Fp       , Gs^Fp       , Gg          , Gg          , Re          , Re          , Gs^Fp       , Gs^Fp       
Gg          , Hh          , Gg          , Re          , Gg          , Gg^Ve       , Gg          , Gs^Fp       , Gs^Fp       , Gg          , Gg          , Ww          , Ww          , Ww          , Ww          , Ww^Bw\      , Ce          , Ww^Bw/      , Ww          , Ww          , Ww          , Ww          , Gg          , Gg          , Gs^Fp       , Gs^Fp       , Gs^Fp       , Gg          , Re^Gvs      , Gs^Fp       , Gs^Fp       , Re          , Gs^Fp       
Re^Gvs      , Gg          , Gg          , Re          , Gg          , Gg          , Gs^Fp       , Gs^Fp       , Gs^Fp       , Gg          , Gg          , Gg          , Gg          , Ww          , Ww^Bw/      , Ww^Bw/      , Ww^Bw|      , Ww^Bw\      , Ww^Bw\      , Ww          , Gg          , Gg          , Gg          , Gg          , Gg^Ve       , Gg          , Re^Gvs      , Re^Gvs      , Re^Gvs      , Re^Gvs      , Re^Gvs      , Re          , Gg          
Re^Gvs      , Re^Gvs      , Gg          , Re          , Gg          , Gg          , Gg          , Gs^Fp       , Re          , Re          , Re          , Re          , Re          , Re          , Gg          , Ww          , Ww^Bw|      , Ww          , Gg          , Re          , Re          , Gg          , Re          , Re          , Re          , Re^Gvs      , Re^Gvs      , Re^Gvs      , Re^Gvs      , Re^Gvs      , Gg^Ve       , Re          , Gg          
Gg          , Gg^Ve       , Re          , Re          , Gg^Wm       , Gg          , Re          , Re          , Gg^Ve       , Gs^Fp       , Gs^Fp       , Gg          , Gg          , Gg          , Gg          , Gg          , Re          , Gg          , Gg          , Gg          , Re          , Gg          , Re          , Gg          , Gg          , Re          , Gg^Wm       , Re^Gvs      , Gs^Fp       , Gg          , Gg          , Re          , Gs^Fp       
Re          , Re          , Gg          , Re          , Re          , Re          , Gg          , Gg          , Re^Gvs      , Re^Gvs      , Re^Gvs      , Gg          , Gg          , Gg          , Gg          , Gg          , Re          , Hh          , Hh          , Hh          , Gg          , Re          , Gg          , Gg          , Gg          , Re          , Re          , Gg          , Gs^Fp       , Gs^Fp       , Gs^Fp       , Re          , Gs^Fp       
Gg          , Gg          , Gg          , Gg          , Gg          , Gg          , Re^Gvs      , Re^Gvs      , Re^Gvs      , Re^Gvs      , Re^Gvs      , Re^Gvs      , Gg          , Gg          , Gg          , Gg          , Re          , Gs^Fp       , Gs^Fp       , Hh          , Gg          , Gg^Ve       , Re^Gvs      , Gg          , Gg          , Gg          , Gg          , Re          , Re          , Re          , Re          , Re          , Re          
Gg          , Gg          , Gg          , Gs^Fp       , Gs^Fp       , Gs^Fp       , Gg          , Re^Gvs      , Re^Gvs      , Re^Gvs      , Gg          , Gg^Ve       , Gg          , Hh          , Hh          , Gg          , Gg          , Re          , Gg          , Gg          , Re^Gvs      , Re^Gvs      , Re^Gvs      , Re^Gvs      , Re^Gvs      , Gg          , Gg          , Gs^Fp       , Gs^Fp       , Gs^Fp       , Gs^Fp       , Gs^Fp       , Gs^Fp       
Gg          , Gg          , Gg          , Gs^Fp       , Gs^Fp       , Gg          , Gs^Fp       , Gg          , Gg          , Gg          , Gg          , Gg          , Hh          , Hh          , Hh          , Hh          , Gg          , Re          , Gg          , Gg          , Gg          , Re^Gvs      , Re^Gvs      , Re^Gvs      , Gg          , Gg          , Gs^Fp       , Gg          , Gg          , Gg          , Gg          , Gs^Fp       , Hh          
Hh          , Gg          , Gg          , Gs^Fp       , Gg          , Gs^Fp       , Gg          , Gg          , Gg          , Gg^Wm       , Gg          , Gg          , Gs^Fp       , Hh          , Gs^Fp       , Hh          , Gg          , Re          , Gg          , Gg          , Gg          , Gg          , Gg          , Gg^Wm       , Gg          , Gg          , Re^Gvs      , Re^Gvs      , Re^Gvs      , Gg^Ve       , Gg          , Hh          , Gs^Fp       
Hh          , Gg          , Gg          , Gg          , Gg^Ve       , Gg          , Re^Gvs      , Re^Gvs      , Re^Gvs      , Gg          , Gg          , Gg          , Gs^Fp       , Gs^Fp       , Ce          , Gg          , Ce          , Re          , Ce          , Gg          , Gg          , Gg          , Gg          , Gg^Ve       , Re^Gvs      , Re^Gvs      , Re^Gvs      , Re^Gvs      , Re^Gvs      , Re^Gvs      , Re^Gvs      , Gs^Fp       , Hh          
Hh          , Hh          , Gg          , Gg          , Gg          , Re^Gvs      , Re^Gvs      , Re^Gvs      , Re^Gvs      , Re^Gvs      , Gg          , Gg          , Gs^Fp       , Gg          , Ce          , Ce          , 1 Ke        , Ce          , Ce          , Gg          , Gg          , Gg          , Gg          , Re^Gvs      , Re^Gvs      , Re^Gvs      , Re^Gvs      , Re^Gvs      , Re^Gvs      , Re^Gvs      , Gg          , Gs^Fp       , Hh          
Hh          , Hh          , Hh          , Gg          , Gg          , Gg          , Gg          , Re^Gvs      , Gg          , Gg          , Gs^Fp       , Gs^Fp       , Gs^Fp       , Gg          , Gg          , Gg          , Gg          , Re          , Re          , Gg          , Gg          , Gg          , Gg          , Gg          , Gg          , Re^Gvs      , Re^Gvs      , Re^Gvs      , Gs^Fp       , Gg          , Hh          , Gs^Fp       , Gs^Fp       
