border_size=1
usage=map

Gg          , Gg          , Gg          , Gg          , Gg          , Gg          , Gg          , Gg          , Gg          , Gg          , Gg          , Gg          , Gg          , Gg          , Gg          , Gg          , Gg          , Gg          , Gg          , Gg          , Gg          , Gg          , Gg          , Gg          , Gg          , Gg          , Gg          , Gg          , Gg          , Gg          , Gg          , Gg          , Gg          
Gg          , Gg          , Gg^Ve       , Gg          , Gg          , Gg          , Gg          , Gg          , Gg          , Gg          , Gg          , Gg          , Gg          , Gg          , Gg          , Gg          , Ww          , Gg          , Gg          , Gg          , Gg          , Gg          , Gg          , Gg          , Gg          , Gg          , Gg          , Gg          , Gg          , Gg          , Gg          , Gg          , Gg          
Gg          , Gg          , Gg          , Gg          , Gg          , Gg          , Gg          , Gg          , Gg          , Gg          , Gg          , Gg          , Gg          , Gg          , Ww          , Ww          , Ww          , Ww          , Ww          , Gg          , Gg          , Gg          , Gg          , Gg^Ve       , Gg          , Gg          , Gg          , Gg          , Gg          , Gg          , Gg          , Gg^Ve       , Gg          
Gg          , Gg          , Gg          , Gg          , Gg          , Gg          , Gg          , Gg^Ve       , Gg          , Gg          , Gg          , Gg          , Ww          , Ww          , Ww          , Ww          , Ww          , Ww          , Ww          , Ww          , Ww          , Gg          , Gg          , Gg          , Gg          , Gg          , Gg          , Gg          , Gg          , Gg          , Gg          , Gg          , Re          
Gg          , Gg          , Gg          , Gg          , Gg          , Gg          , Gg          , Gg          , Gg          , Gg          , Ww          , Ww          , Ww          , Ww          , Ww^Bw/      , Ce          , Ce          , Ce          , Ww^Bw\      , Ww          , Ww          , Ww          , Ww          , Gg          , Gg          , Gg          , Gg          , Gg          , Gg          , Gg          , Gg          , Re          , Gg          
Re          , Gg          , Gg          , Gg          , Gg          , Gg          , Gg          , Gg          , Ww          , Ww          , Ww          , Ww          , Ww^Bw/      , Ce          , Ce          , Ww          , Ww          , Ww          , Ce          , Ce          , Ww^Bw\      , Ww          , Ww          , Ww          , Ww          , Gg          , Gg          , Gg          , Gg          , Gg          , Gg          , Re          , Gg          
Gg          , Re          , Re          , Gg          , Gg          , Gg          , Ww          , Ww          , Ww          , Ww          , Ww^Bw/      , Ce          , Ce          , Ww          , Ww          , Ce          , Ce          , Ce          , Ww          , Ww          , Ce          , Ce          , Ww^Bw\      , Ww          , Ww          , Ww          , Ww          , Gg          , Re          , Re          , Re          , Re          , Gg          
Gg          , Re          , Gg          , Re          , Re          , Re          , Ww^Bw\      , Ww          , Ww          , Ce          , Ce          , Ww          , Ww          , Ce          , Ce          , Ww          , Ww          , Ww          , Ce          , Ce          , Ww          , Ww          , Ce          , Ce          , Ww          , Ww          , Ww^Bw/      , Re          , Gg          , Gg          , Gg          , Re          , Gg          
Gg          , Re          , Gg^Ve       , Gg          , Gg          , Gg          , Gg          , Ww^Bw\      , Ce          , Ww          , Ww          , Ce          , Ce          , Ww          , Ww          , Ce          , Ce          , Ce          , Ww          , Ww          , Ce          , Ce          , Ww          , Ww          , Ce          , Ww^Bw/      , Gg          , Gg          , Gg          , Gg          , Re          , Re          , Gg          
Gg          , Re          , Re          , Gg          , Re          , Gg          , Ww^Bw/      , Ww^Bw/      , Ce          , Ww^Bw\      , Ce          , Ww          , Ww          , Ce          , Ce          , Wwf         , Wwf         , Wwf         , Ce          , Ce          , Ww          , Ww          , Ce          , Ww^Bw/      , Ce          , Ww^Bw\      , Ww^Bw\      , Gg          , Gg          , Gg          , Re          , Gg          , Gg          
Gg          , Gg          , Gg          , Re          , Gg          , Re          , Ww          , Ww          , Ce          , Ww          , Ce          , Ww^Bw\      , Ce          , Wwf         , Wwf         , Ce          , Ce          , Ce          , Wwf         , Wwf         , Ce          , Ww^Bw/      , Ce          , Ww          , Ce          , Ww          , Ww          , Re          , Re          , Re          , Gg^Ve       , Gg          , Gg          
Gg          , Gg          , Gg          , Gg          , Gg          , Gg          , Ww          , Ww          , Ce          , Ww          , Ce          , Ww^Bw/      , Ce          , Wwf         , Ce          , Wwf         , Wwf         , Wwf         , Ce          , Wwf         , Ce          , Ww          , Ce          , Ww          , Ce          , Ww          , Ww          , Gg          , Gg          , Gg          , Gg          , Gg          , Gg          
Gg          , Gg          , Gg          , Gg          , Gg          , Gg          , Ww          , Ww          , Ce          , Ww          , Ce          , Ww          , 2 Ke        , Wwf         , Wwf         , Wwf         , 3 Ke        , Wwf         , Wwf         , Wwf         , 4 Ke        , Ww          , Ce          , Ww          , Ce          , Ww          , Ww          , Gg          , Gg          , Gg          , Gg          , Gg          , Gg          
Gg          , Gg          , Gg          , Gg          , Gg          , Gg          , Ww^Bw/      , Ww^Bw/      , Ce          , Ww          , Ce          , Ww          , Ce          , Wwf         , Ce          , Ce          , Wwf         , Ce          , Ce          , Wwf         , Ce          , Ww          , Ce          , Ww          , Ce          , Ww^Bw\      , Ww^Bw\      , Gg          , Gg          , Gg          , Gg          , Gg          , Gg          
Gg          , Gg          , Gg          , Gg          , Re          , Re          , Ww          , Ww          , Ce          , Ww          , Ce          , Ww          , Ce          , Wwf         , Wwf         , Wwf         , Ce          , Wwf         , Wwf         , Wwf         , Ce          , Ww          , Ce          , Ww          , Ce          , Ww          , Ww          , Re          , Re          , Gg          , Gg          , Gg          , Gg          
Gg          , Gg          , Gg          , Gg          , Re          , Gg          , Ww          , Ww          , Ce          , Ww          , Ce          , Ww          , Ww          , Wwf         , Ce          , Ce          , Wwf         , Ce          , Ce          , Wwf         , Ww          , Ww          , Ce          , Ww          , Ce          , Ww          , Ww          , Gg          , Re          , Gg^Ve       , Gg          , Gg          , Gg          
Gg          , Gg^Ve       , Re          , Re          , Gg          , Gg          , Ww          , Ww          , Ce          , Ce          , Ww          , Ww          , Ce          , Ce          , Ww          , Wwf         , Ce          , Wwf         , Ww          , Ce          , Ce          , Ww          , Ww          , Ce          , Ce          , Ww          , Ww          , Gg          , Gg          , Re          , Gg          , Gg          , Gg          
Gg          , Gg          , Re          , Gg          , Gg          , Gg          , Ww^Bw/      , Ww^Bw/      , Ww          , Ww^Bw\      , Ce          , Ce          , Ww          , Ww          , Ce          , Ce          , Ww          , Ce          , Ce          , Ww          , Ww          , Ce          , Ce          , Ww^Bw/      , Ww          , Ww^Bw\      , Ww^Bw\      , Gg          , Gg          , Re          , Re          , Gg          , Gg          
Gg          , Gg          , Re          , Gg          , Re          , Re          , Gg          , Ww          , Ww          , Ww          , Ww          , Ww^Bw\      , Ce          , Ce          , Ww^Bw|      , Ww          , Ce          , Ww          , Ww^Bw|      , Ce          , Ce          , Ww^Bw/      , Ww          , Ww          , Ww          , Ww          , Gg          , Re          , Re          , Gg          , Re          , Gg          , Gg          
Gg          , Gg          , Re          , Gg          , Re          , Gg          , Gg          , Gg          , Gg          , Ww          , Ww          , Ww          , Ww          , Ww^Bw\      , Ce          , Ce          , Ww          , Ce          , Ce          , Ww^Bw/      , Ww          , Ww          , Ww          , Ww          , Gg          , Gg          , Gg          , Gg          , Gg          , Re          , Re          , Gg          , Gg          
Gg          , Gg          , Gg          , Re          , Gg          , Gg^Ve       , Gg          , Gg          , Gg          , Gg          , Gg          , Ww          , Ww          , Ww          , Ww          , Ww^Bw\      , Ce          , Ww^Bw/      , Ww          , Ww          , Ww          , Ww          , Gg          , Gg          , Gg          , Gg          , Gg          , Gg          , Gg          , Gg          , Gg          , Re          , Gg          
Gg          , Gg          , Gg          , Re          , Gg          , Gg          , Gg          , Gg          , Gg          , Gg          , Gg          , Gg          , Gg          , Ww          , Ww^Bw/      , Ww^Bw/      , Ww^Bw|      , Ww^Bw\      , Ww^Bw\      , Ww          , Gg          , Gg          , Gg          , Gg          , Gg^Ve       , Gg          , Gg          , Gg          , Gg          , Gg          , Gg          , Re          , Gg          
Gg          , Gg          , Gg          , Re          , Gg          , Gg          , Gg          , Gg          , Re          , Re          , Re          , Re          , Re          , Re          , Gg          , Ww          , Ww^Bw|      , Ww          , Gg          , Re          , Re          , Gg          , Re          , Re          , Re          , Gg          , Gg          , Gg          , Gg          , Gg          , Gg^Ve       , Re          , Gg          
Gg          , Gg^Ve       , Re          , Re          , Gg          , Gg          , Re          , Re          , Gg^Ve       , Gg          , Gg          , Gg          , Gg          , Gg          , Gg          , Gg          , Re          , Gg          , Gg          , Gg          , Re          , Gg          , Re          , Gg          , Gg          , Re          , Gg          , Gg          , Gg          , Gg          , Gg          , Re          , Gg          
Re          , Re          , Gg          , Re          , Re          , Re          , Gg          , Gg          , Gg          , Gg          , Gg          , Gg          , Gg          , Gg          , Gg          , Gg          , Re          , Gg          , Gg          , Gg          , Gg          , Re          , Gg          , Gg          , Gg          , Re          , Re          , Gg          , Gg          , Gg          , Gg          , Re          , Gg          
Gg          , Gg          , Gg          , Gg          , Gg          , Gg          , Gg          , Gg          , Gg          , Gg          , Gg          , Gg          , Gg          , Gg          , Gg          , Gg          , Re          , Gg          , Gg          , Gg          , Gg          , Gg^Ve       , Gg          , Gg          , Gg          , Gg          , Gg          , Re          , Re          , Re          , Re          , Re          , Re          
Gg          , Gg          , Gg          , Gg          , Gg          , Gg          , Gg          , Gg          , Gg          , Gg          , Gg          , Gg^Ve       , Gg          , Gg          , Gg          , Gg          , Gg          , Re          , Gg          , Gg          , Gg          , Gg          , Gg          , Gg          , Gg          , Gg          , Gg          , Gg          , Gg          , Gg          , Gg          , Gg          , Gg          
Gg          , Gg          , Gg          , Gg          , Gg          , Gg          , Gg          , Gg          , Gg          , Gg          , Gg          , Gg          , Gg          , Gg          , Gg          , Gg          , Gg          , Re          , Gg          , Gg          , Gg          , Gg          , Gg          , Gg          , Gg          , Gg          , Gg          , Gg          , Gg          , Gg          , Gg          , Gg          , Gg          
Gg          , Gg          , Gg          , Gg          , Gg          , Gg          , Gg          , Gg          , Gg          , Gg          , Gg          , Gg          , Gg          , Gg          , Gg          , Gg          , Gg          , Re          , Gg          , Gg          , Gg          , Gg          , Gg          , Gg          , Gg          , Gg          , Gg          , Gg          , Gg          , Gg^Ve       , Gg          , Gg          , Gg          
Gg          , Gg          , Gg          , Gg          , Gg^Ve       , Gg          , Gg          , Gg          , Gg          , Gg          , Gg          , Gg          , Gg          , Gg          , Ce          , Gg          , Ce          , Re          , Ce          , Gg          , Gg          , Gg          , Gg          , Gg^Ve       , Gg          , Gg          , Gg          , Gg          , Gg          , Gg          , Gg          , Gg          , Gg          
Gg          , Gg          , Gg          , Gg          , Gg          , Gg          , Gg          , Gg          , Gg          , Gg          , Gg          , Gg          , Gg          , Gg          , Ce          , Ce          , 1 Ke        , Ce          , Ce          , Gg          , Gg          , Gg          , Gg          , Gg          , Gg          , Gg          , Gg          , Gg          , Gg          , Gg          , Gg          , Gg          , Gg          
Gg          , Gg          , Gg          , Gg          , Gg          , Gg          , Gg          , Gg          , Gg          , Gg          , Gg          , Gg          , Gg          , Gg          , Gg          , Gg          , Gg          , Re          , Re          , Gg          , Gg          , Gg          , Gg          , Gg          , Gg          , Gg          , Gg          , Gg          , Gg          , Gg          , Gg          , Gg          , Gg          
