border_size=1
usage=map

Gg          , Gg          , Gg          , Gg          , Gg          , Gg          , Gg          , Gg          , Mm          , Mm          , Mm          , Gg          , Gg          , Gg          , Gg          , Gg          , Hh          , Hh          , Hh          , Hh          , Mm          , Mm          
Gg          , Gg          , Gg          , Gg          , Mm          , Mm          , Mm          , Gg          , Mm          , Mm^Vhh      , Mm          , Mm          , Hh          , Hh          , Gg          , Hh          , Mm          , Mm          , Mm          , Mm          , Mm          , Mm          
Gg          , Gg          , Gg          , Gg          , Gg          , Mm          , Mm          , Mm          , Mm          , Mm          , Gg          , Mm          , Gg          , Gg          , Gg          , Hh          , Mm^Vhh      , Mm          , Mm          , Mm          , Mm          , Mm          
Gg          , Gg          , Gg          , Gg          , Gg          , Hh          , Hh          , Mm          , Gg          , Mm          , Gg          , Gg          , Gg          , Hh          , Cud         , Cud         , Qxu         , Mm          , Mm          , Mm          , Mm          , Mm          
Hh          , Gg          , Hh^Vhh      , Gg          , Gg          , Gg          , Mm          , Gg          , Gg          , Gg          , Gg          , Gg          , Gg          , Mm          , Mm          , 2 Kud       , Cud         , Cud         , Mm          , Mm          , Mm          , Mm          
Gg          , Hh          , Gg          , Gg          , Gg          , Mm          , Mm          , Mm          , Gg          , Gg          , Mm          , Mm          , Mm          , Hh          , Mm          , Cud         , Mm          , Cud         , Mm          , Mm          , Mm^Vhh      , Mm          
Gg          , Gg          , Hh          , Gg          , Hh          , Hh          , Gg          , Gg          , Gg          , Hh          , Hh          , Mm          , Gg          , Hh          , Gg          , Gg          , Hh          , Hh          , Gg          , Mm          , Mm          , Mm          
Gg          , Gg          , Mm          , Gg          , Gg          , Gg          , Gg          , Hh          , Gg          , Hh          , Hh          , Gg          , Mm          , Gg          , Mm          , Mm          , Mm          , Hh          , Mm          , Mm          , Gg          , Gg          
Hh          , Mm          , Mm          , Mm          , Gg          , Gg          , Gg          , Hh          , Hh          , Hh          , Gg          , Mm          , Mm          , Mm          , Hh          , Mm          , Gg          , Gg          , Hh          , Hh          , Hh          , Mm          
Hh          , Hh          , Gg          , Gg          , Gg          , Hh          , Gg          , Hh^Vhh      , Gg          , Hh          , Hh          , Gg          , Gg          , Gg          , Mm          , Hh          , Gg          , Hh          , Mm          , Mm          , Mm          , Mm          
Gg          , Gg          , Gg          , Hh          , Hh          , Hh          , Gg          , Gg          , Gg          , Hh          , Gg          , Gg          , Gg          , Mm          , Mm          , Mm          , Hh          , Hh          , Mm          , Mm          , Mm          , Mm          
Gg          , Gg          , Gg          , Gg          , Gg          , Gg          , Gg          , Hh          , Hh          , Gg          , Gg          , Hh          , Mm          , Gg          , Gg          , Gg          , Hh          , Hh          , Hh          , Mm          , Mm^Vhh      , Mm          
Gg          , Hh          , Hh          , Hh          , Hh          , Gg          , Gg          , Hh          , Gg          , Hh          , Gg          , Mm          , Mm          , Mm          , Hh          , Hh          , Mm          , Gg          , Hh          , Hh          , Mm          , Mm          
Gg          , Gg          , Gg          , Hh^Vhh      , Gg          , Hh          , Gg          , Gg          , Hh          , Hh          , Gg          , Gg          , Gg          , Gg          , Gg          , Mm          , Mm          , Mm          , Hh          , Mm          , Mm          , Mm          
Gg          , Gg          , Gg          , Gg          , Gg          , Hh          , Gg          , Gg          , Hh          , Hh          , Gg          , Hh          , Mm          , Hh          , Hh          , Mm          , Mm          , Hh          , Mm          , Mm          , Mm          , Mm          
Gg          , Gg          , Gg          , Gg          , Hh          , Hh          , Hh          , Gg          , Gg          , Gg          , Hh          , Mm          , Mm          , Mm          , Mm          , Mm^Vhh      , Mm          , Gg          , Mm          , Mm          , Hh          , Hh          
Gg          , Gg          , Gg          , Gg          , Gg          , Gg          , Gg          , Gg          , Gg          , Gg          , Mm          , Mm          , Mm          , Mm          , Mm          , Mm          , Mm          , Mm          , Mm          , Hh          , Hh          , Hh          
Gg          , Gg          , Gg          , Gg          , Ce          , Gg          , Gg          , Gg          , Hh          , Hh          , Gg          , Mm          , Gg          , Mm          , Mm          , Mm          , Mm          , Mm          , Mm          , Mm          , Gg          , Hh          
Gg          , Gg          , Ce          , 1 Ke        , Ce          , Ce          , Gg          , Gg          , Gg          , Hh          , Gg          , Gg          , Hh          , Gg          , Hh          , Gg          , Hh          , Hh          , Hh          , Hh          , Mm          , Hh          
Gg          , Gg          , Gg          , Ce          , Gg          , Ce          , Gg          , 3 Gg        , Gg          , Hh          , Hh          , Hh          , Mm          , Hh          , Gg          , Hh          , Mm          , Hh          , Mm          , Mm          , Mm          , Mm          
Gg          , Gg          , Gg          , Gg          , Gg          , Gg          , Hh          , Gg          , Hh          , Mm          , Mm          , Mm          , Mm          , Hh          , Hh          , Gg          , Hh          , Mm^Vhh      , Mm          , Mm          , Mm          , Mm          
Gg          , Gg          , Gg          , Gg          , Gg          , Gg          , Gg          , Hh          , Mm          , Mm^Vhh      , Mm          , Mm          , Mm          , Hh          , Mm          , Gg          , Mm          , Mm          , Mm          , Mm          , Mm          , Mm          
