border_size=1
usage=map

Uu          , Uu          , Xu          , Uu          , Uu          , Uu          , Xu          , Uu          , Ww          , Ww          , Xu          , Xu          , Xu          , Xu          , Xu          , Uu          , Ww          , Uu          , Xu          , Uu          , Wo          , Uu          , Xu          , Uu          , Ww          
Uu          , Uu          , Xu          , Uu^Vu       , Uu          , Wo          , Xu          , Uu^Vu       , Ww          , Xu          , Cud         , Cud         , Cud         , Cud         , Cud         , Xu          , Ww          , Uu^Vud      , Xu          , Wo          , Uu          , Uu^Vud      , Xu          , Uu          , Uu          
Uu          , Ww          , Xu          , Wo          , Ww          , Uu          , Xu          , Ww          , Ww          , Cud         , Cud         , Xu          , 2 Kud       , Xu          , Cud         , Cud         , Uu          , Ww          , Xu          , Ww          , Uu          , Uu          , Xu          , Ww          , Ww          
Wo          , Uu          , Xu          , Uu          , Uu          , Uu          , Xu          , Uu          , Ww          , Ww          , Cud         , Ww          , Ww          , Ww          , Cud         , Ww          , Ww          , Ww          , Xu          , Uu          , Uu          , Ww          , Xu          , Uu          , Uu          
Uu          , Ww          , Xu          , Ww          , Uu          , Ww          , Xu          , Ww          , Ww          , Xu          , Xu          , Xu          , Uu^Ii       , Xu          , Xu          , Xu          , Uu          , Ww          , Xu          , Uu          , Ww          , Uu          , Xu          , Ww          , Uu          
Uu          , Ww          , Xu          , Uu          , Uu          , Ww          , Xu          , Uu          , Uu          , Ww          , Uu          , Xu          , Xu          , Xu          , Uu          , Uu          , Ww          , Uu          , Xu          , Uu          , Uu          , Ww          , Xu          , Uu          , Uu          
Uu          , Uu          , Xu          , Ww          , Uu          , Uu          , Xu          , Uu          , Uu          , Uu          , Uu          , Ww          , Ww          , Ww          , Uu          , Uu          , Uu          , Ww          , Xu          , Ww          , Uu          , Uu          , Xu          , Ww          , Uu          
Uu          , Ww          , Xu          , Ww          , Uu          , Uu^Vu       , Xu          , Uu          , Uu          , Uu^Vud      , Xu          , Xu          , Uu          , Xu          , Xu          , Uu^Vud      , Uu          , Uu          , Xu          , Uu          , Wo          , Uu^Vu       , Xu          , Uu          , Ww          
Uu          , Uu          , Xu          , Uu          , Uu          , Uu          , Ww          , Uu          , Xu          , Xu          , Uu          , Uu          , Xu          , Uu          , Wo          , Xu          , Xu          , Uu          , Ww          , Uu          , Uu          , Ww          , Xu          , Ww          , Uu          
Uu          , Ww          , Xu          , Ww          , Uu          , Wo          , Ww          , Xu          , Uu          , Xu          , Uu          , Uu          , Ww          , Uu          , Ww          , Xu          , Uu          , Xu          , Ww          , Ww          , Uu          , Ww          , Xu          , Uu          , Ww          
Uu          , Uu          , Ww          , Uu          , Xu          , Xu          , Uu          , Uu          , Xu          , Uu          , Uu          , Xu          , Xu          , Xu          , Uu          , Uu          , Xu          , Uu          , Uu          , Xu          , Xu          , Uu          , Ww          , Uu          , Uu          
Uu          , Ww          , Wo          , Xu          , Uu          , Xu          , Uu          , Uu          , Ww          , Ww          , Uu          , Xu          , Ww          , Xu          , Uu          , Ww          , Ww          , Uu          , Uu          , Xu          , Uu          , Xu          , Wo          , Ww          , Uu          
Xu          , Xu          , Uu          , Uu          , Xu          , Uu          , Uu          , Xu          , Xu          , Xu          , Wo          , Uu          , Xu          , Uu          , Uu          , Xu          , Xu          , Xu          , Uu          , Uu          , Xu          , Uu          , Uu          , Xu          , Xu          
Uu          , Xu          , Xu          , Uu          , Ww          , Ww          , Uu          , Xu          , Uu          , Xu          , Ww          , Uu          , Uu          , Uu          , Uu          , Xu          , Uu          , Xu          , Ww          , Uu          , Ww          , Ww          , Xu          , Xu          , Uu          
Uu          , Uu          , Uu          , Xu          , Xu          , Xu          , Uu          , Uu          , Xu          , Uu          , Uu          , Xu          , Uu          , Xu          , Uu          , Uu          , Xu          , Uu          , Wo          , Xu          , Xu          , Xu          , Uu          , Wo          , Uu          
Xu          , Uu          , Uu          , Ww          , Uu          , Xu          , Xu          , Uu          , Uu          , Uu          , Uu          , Xu          , 3 Uu        , Xu          , Uu          , Ww          , Ww          , Uu          , Xu          , Xu          , Uu          , Uu          , Wo          , Uu          , Xu          
Uu          , Xu          , Xu          , Uu          , Uu          , Uu          , Ww          , Xu          , Xu          , Xu          , Ww          , Uu          , Xu          , Uu          , Uu          , Xu          , Xu          , Xu          , Uu          , Uu          , Uu          , Ww          , Xu          , Xu          , Ww          
Uu          , Uu^Vud      , Uu          , Xu          , Xu          , Uu          , Uu          , Uu          , Ww          , Xu          , Xu          , Uu          , Uu          , Uu          , Xu          , Xu          , Ww          , Uu          , Uu          , Uu          , Xu          , Xu          , Uu          , Uu^Vud      , Wo          
Xu          , Uu          , Uu          , Wo          , Uu          , Xu          , Xu          , Uu          , Uu          , Uu          , Ww          , Xu          , Xu          , Xu          , Uu          , Ww          , Uu          , Uu          , Xu          , Xu          , Uu          , Ww          , Uu          , Uu          , Xu          
Uu          , Xu          , Xu          , Uu          , Uu          , Wo          , Ww          , Xu          , Xu          , Uu          , Uu          , Ww          , Uu          , Uu          , Ww          , Uu          , Xu          , Xu          , Ww          , Uu          , Ww          , Uu          , Xu          , Xu          , Uu          
Uu          , Uu^Vu       , Uu          , Xu          , Xu          , Uu          , Uu          , Uu          , Uu          , Xu          , Xu          , Uu          , Uu          , Ww          , Xu          , Xu          , Uu          , Ww          , Uu          , Uu          , Xu          , Xu          , Uu          , Uu^Vu       , Ww          
Xu          , Wo          , Uu          , Ww          , Uu          , Xu          , Xu          , Uu          , Uu          , Uu          , Ww          , Ww          , Uu          , Uu          , Uu          , Uu          , Ww          , Uu          , Xu          , Xu          , Uu          , Ww          , Uu          , Ww          , Xu          
Uu          , Xu          , Xu          , Uu          , Uu          , Ww          , Ww          , Xu          , Uu          , Uu          , Uu          , Uu          , Cud         , Uu          , Ww          , Uu          , Ww          , Xu          , Uu          , Uu          , Uu          , Uu          , Xu          , Xu          , Uu          
Ww          , Uu^Vud      , Uu          , Xu          , Xu          , Uu          , Uu          , Uu          , Uu          , Uu          , Cud         , Cud         , Uu^Uf       , Cud         , Cud         , Uu          , Uu          , Uu          , Uu          , Wo          , Xu          , Xu          , Uu          , Uu^Vu       , Uu          
Xu          , Uu          , Uu          , Uu          , Uu          , Uu          , Xu          , Uu          , Ww          , Ww          , Cud         , Uu^Uf       , 1 Uu^Ufi    , Uu^Uf       , Cud         , Uu          , Uu          , Uu          , Xu          , Ww          , Uu          , Uu          , Ww          , Uu          , Xu          
Uu          , Xu          , Ww          , Uu          , Ww          , Uu          , Ww          , Xu          , Xu          , Uu          , Cud         , Uu^Uf       , Uu^Uf       , Uu^Uf       , Cud         , Uu          , Xu          , Xu          , Uu          , Uu          , Uu          , Uu          , Uu          , Xu          , Uu          
Ww          , Uu          , Wo          , Xu          , Xu          , Uu          , Uu          , Uu          , Uu          , Uu          , Uu          , Cud         , Cud         , Cud         , Uu          , Ww          , Ww          , Uu          , Ww          , Ww          , Xu          , Xu          , Uu          , Wo          , Uu          
Uu          , Uu          , Uu          , Uu          , Uu^Vud      , Xu          , Xu          , Ww          , Ww          , Uu          , Ww          , Uu          , Uu          , Uu          , Ww          , Uu          , Uu          , Uu          , Xu          , Xu          , Uu^Vud      , Ww          , Uu          , Uu          , Uu          
Uu          , Xu          , Xu          , Uu          , Uu          , Uu          , Uu          , Xu          , Xu          , Uu          , Wo          , Ww          , Uu          , Wo          , Uu          , Uu          , Xu          , Xu          , Uu          , Ww          , Wo          , Uu          , Xu          , Xu          , Ww          
