border_size=1
usage=map

Ww          , Ww          , Uu^Uf       , Uu^Uf       , Uu^Uf       , Uu^Uf       , Xu          , Uu          , Re          , Uu          , Uu          , Re          , Uu          , Re          , Re          , Uu          , Re          , Re          , Xu          , Xu          , Xu          , Gs^Fp       , Gs^Fp       , Gs^Fp       , Gs^Fp       , Gs^Fp       , Gs^Fp       , Ggf         , Ggf         , Ggf         , Ggf         , Ggf         
Uu^Uf       , Uu^Uf       , Uu^Vu       , Uu^Uf       , Xu          , Xu          , Cud         , Re          , Uu          , Uu          , Uu          , Uu          , Uu          , Uu          , Uu          , Re          , Uu          , Uh          , Uh          , Uh          , Uu          , Xu          , Xu          , Hh          , Hh          , Hh          , Gs^Fp       , Gs^Fp       , Ggf         , Gs^Fp       , Gg^Ve       , Gg^Wm       
Uu^Uf       , Uu          , Uu          , Uu^Uf       , Xu          , Cud         , 4 Kud       , Re          , Uu          , Uu          , Uu          , Uh          , Uh          , Uu          , Uu          , Re          , Re          , Uh          , Uu          , Xu          , Xu          , Uu          , Uh          , Xu          , Xu          , Hh          , Hh          , Gs^Fp       , Ggf         , Ggf         , Gs^Fp       , Gs^Fp       
Uu          , Uu          , Uu          , Uu          , Xu          , Xu          , Re          , Re          , Cud         , Uu          , Uu^Vu       , Uu          , Uu          , Uh          , Uh          , Uu          , Uu          , Re          , Uu          , Uu^Vud      , Xu          , Xu          , Xu          , Uh          , Xu          , Hh          , Gs^Fp       , Gs^Fp       , Ggf         , Gs^Fp       , Gg^Fet      , Gs^Fp       
Uu          , Uu          , Xu          , Xu          , Re          , Re          , Xu          , 5 Kud       , Cud         , Uu          , Xu          , Xu          , Uh          , Uh          , Uh          , Uh          , Uu          , Re          , Uu          , Xu          , Uu^Ii       , Uh          , Uh          , Uu          , Xu          , Hh          , Gs^Fp       , Ggf         , Ggf         , Gs^Fp       , Gs^Fp       , Gs^Fp       
Uu          , Uu          , Xu          , Cud         , Re          , Cud         , Xu          , Xu          , Xu          , Uu          , Xu          , Xu          , Xu          , Xu          , Uh          , Uu          , Re          , Re          , Uh          , Xu          , Xu          , Xu          , Xu          , Xu          , Hh          , Gs^Fp       , Gg^Fet      , Gs^Fp       , Gs^Fp       , Ggf         , Gs^Fp       , Gs^Fp       
Uu          , Uu          , Uu^Vud      , Xu          , Re          , Xu          , Uu          , Uu          , Uu          , Xu          , Uu          , Uh          , Uh          , Xu          , Uu          , Re          , Uu          , Uu          , Uh          , Uh          , Xu          , Mm          , Mm          , Mm          , Xu          , Gs^Fp       , Mm          , Hh          , Gs^Fp       , Ggf         , Ggf         , Gs^Fp       
Uu          , Uu          , Uu          , Uu^Uf       , Uu^Uf       , Re          , Re          , Re          , Uu          , Uu^Vud      , Uu^Uf       , Uh          , Uh          , Xu          , Uu^Vu       , Re          , Re          , Uu          , Uh          , Uh          , Uh          , Xu          , Xu          , Xu          , Uh          , Xu          , Xu          , Hh          , Hh          , Gs^Fp       , Gs^Fp       , Ggf         
Uu^Uf       , Uu^Uf       , Uu^Uf       , Uu          , Uu^Uf       , Uu^Uf       , Uu^Uf       , Re          , Re          , Uu^Uf       , Uu^Uf       , Uu^Uf       , Uh          , Xu          , Xu          , Uu          , Uu          , Re          , Uu          , Uu          , Uu          , Uh          , Uh          , Uh          , Uu          , Uh          , Xu          , Xu          , Xu          , Gg^Fet      , Ggf         , Ggf         
Uu^Uf       , Ww          , Uu          , Uu          , Uu          , Uu^Uf       , Wwf         , Re          , Uu^Uf       , Uu^Uf       , Ww          , Uu^Uf       , Uu^Uf       , Uu^Uf       , Xu          , Xu          , Xu          , Re          , Re          , Uu          , Uu          , Uh          , Uh          , Uu          , Uu^Vu       , Uh          , Uu          , Uu          , Xu          , Gs^Fp       , Ggf         , Gs^Fp       
Uu          , Uu^Vu       , Uu^Uf       , Uu^Uf       , Ww          , Uu          , Wwf         , Ww          , Uu          , Uu          , Uu          , Uu          , Uu          , Uu^Vu       , Ww          , Ww          , Ww          , Xu          , Cud         , Re          , Re          , Uu          , Uu          , Uu          , Xu          , Xu          , Xu          , Xu          , Gg^Ve       , Gs^Fp       , Ggf         , Gs^Fp       
Uu^Uf       , Ww          , Ww          , Uu^Uf       , Uu^Uf       , Wwf         , Uu^Uf       , Ww          , Uu^Uf       , Uu^Uf       , Ww          , Ww          , Uu^Uf       , Ww          , Wo          , Wo          , Xu          , Xu          , Uu^Uf       , Re          , Cud         , Re          , Re          , Cud         , Xu          , Ggf         , Ggf         , Ggf         , Ggf         , Gg^Wm       , Ggf         , Gs^Fp       
Uu^Uf       , Ww          , Uu^Uf       , Uu^Uf       , Wwf         , Wwf         , Uh          , Uu^Uf       , Ww          , Uu^Uf       , Uu^Uf       , Uu^Uf       , Uu^Uf       , Ww          , Wo          , Xu          , Wo          , Ww          , Cud         , Re          , Uu^Uf       , Cud         , Re          , Cud         , Uu          , Xu          , Xu          , Xu          , Xu          , Ggf         , Ggf         , Gs^Fp       
Uu^Uf       , Uu^Uf       , Uh          , Uh          , Re          , Uu          , Uh          , Uh          , Uu^Uf       , Ww          , Uu^Uf       , Xu          , Uu^Uf       , Ww          , Xu          , Xu          , Ww          , Ww          , Re          , Re          , Uu^Uf       , Uu          , Re          , Uu          , Cud         , Cud         , Cud         , Uu          , Uu          , Xu          , Ggf         , Gs^Fp       
Uu^Uf       , Uu^Uf       , Uh          , Uh          , Uh          , Re          , Re          , Uu          , Uu          , Uu^Vud      , Uh          , Xu          , Xu          , Xu          , Re          , Re          , Re          , Re          , Cud         , Uu^Uf       , Uu^Uf       , Uu^Vud      , Uu          , Re          , Cud         , Kud         , Re          , Re          , Uu          , Xu          , Ggf         , Gs^Fp       
Uu          , Uu^Uf       , Uh          , Uh          , Uh          , Uu          , Uu          , Re          , Re          , Uu          , Uh          , Uh          , Xu          , Cud         , Re          , Ww          , Ww          , Ww          , Ww          , Ww          , Ww          , Uu^Uf       , Cud         , Re          , Re          , Re          , Uu^Uf       , Re          , Uu^Vu       , Xu          , Xu          , Ww          
Uu          , Uu          , Uu          , Uh          , Uh          , Uh          , Uu          , Uu          , Re          , Uh          , Uh          , Uh          , Xu          , Re          , Uu^Uf       , Cud         , Uu^Uf       , Ww          , Ww          , Ww          , Ww          , Uu^Uf       , Uu^Uf       , Uu^Uf       , Uu          , Uu^Uf       , Ww          , Re          , Re          , Ww          , Xu          , Ww          
Uu          , Uu^Vud      , Uu          , Uu          , Uu          , Uu          , Uu          , Uu          , Re          , Uu          , Uu          , Uh          , Xu          , Re          , Uu          , Uu^Uf       , Uu^Uf       , Uu^Uf       , Uu^Vu       , Ww          , Ww          , Ww          , Uu^Uf       , Uu          , Ww          , Ww          , Xu          , Wo          , Xu          , Xu          , Re          , Xu          
Uu          , Uu          , Cud         , Cud         , Cud         , Uu          , Re          , Re          , Uu          , Uu          , Uu          , Uu^Vu       , Xu          , Re          , Re          , Uu^Uf       , Uu          , Uu          , Uu          , Ww          , Ww          , Ww          , Wwf         , Wwf         , Xu          , Xu          , Ww          , Xu          , Wo          , Wo          , Ww          , Re          
Uu          , Cud         , Re          , Re          , Re          , Re          , Uu          , Uu          , Uu^Uf       , Uu          , Uu          , Uu          , Xu          , Uu          , Cud         , Re          , Uu          , Uu^Uf       , Uu^Uf       , Uu^Uf       , Uu^Uf       , Ww          , Wwf         , Ww          , Xu          , Uu^Ufi      , Uu^Uf       , Ww          , Ww          , Ww          , Uu^Uf       , Uu          
Uu          , Cud         , Cud         , 2 Kud       , Re          , Cud         , Uu^Uf       , Uu^Uf       , Xu          , Xu          , Xu          , Xu          , Uu^Vu       , Uu          , Uu          , Re          , Uu^Uf       , Uu^Uf       , Uu^Uf       , Uu^Uf       , Uu          , Uu^Uf       , Uu          , Ww          , Ww          , Xu          , Uu^Uf       , Uu^Uf       , Uu^Uf       , Uu          , Uu          , Uu          
Uu          , Cud         , Cud         , Re          , Cud         , Cud         , Uu^Uf       , Uu^Uf       , Xu          , Uu^Uf       , Uu^Uf       , Uu^Uf       , Uu          , Uu          , Uu          , Re          , Re          , Uu^Uf       , Uu          , Uu          , Uu^Uf       , Uu          , Uu^Uf       , Uu^Uf       , Uu^Vud      , Xu          , Xu          , Xu          , Xu          , Xu          , Xu          , Uu          
Uu          , Uu          , Xu          , Cud         , Uu          , Uu^Uf       , Xu          , Xu          , Xu          , Xu          , Uu^Uf       , Uu^Uf       , Uu^Uf       , Uu          , Uu          , Uu          , Cud         , Re          , Re          , Uu^Uf       , Uu          , Uu^Uf       , Uu^Uf       , Uu          , Uu          , Uu          , Uu          , Uh          , Uh          , Uh          , Xu          , Uh          
Uu          , Xu          , Uu^Uf       , Xu          , Xu          , Xu          , Uu^Uf       , Uu^Uf       , Uu^Uf       , Uu^Uf       , Uu          , Uu^Uf       , Uu          , Re          , Uu          , Uu          , Re          , Re          , Uu          , Re          , Re          , Uu^Uf       , Uu          , Uu^Uf       , Uu          , Uu          , Uu          , Uh          , Uh          , Uh          , Xu          , Uh          
Xu          , Xu          , Uu^Uf       , Uu^Uf       , Uu^Uf       , Uu^Uf       , Uu          , Cud         , Cud         , Cud         , Re          , Re          , Re          , Re          , Re          , Uu          , Re          , Uu          , Uu          , Uu^Vud      , Xu          , Re          , Re          , Uu          , Uu          , Uu          , Uu          , Uu          , Uu          , Uh          , Xu          , Uh          
Ww          , Xu          , Xu          , Uu          , Uu          , Uu^Uf       , Cud         , Re          , Re          , Re          , Cud         , Uu          , Uu          , Cud         , Uu          , Re          , Uu          , Uu          , Uu          , Xu          , Xu          , Xu          , Xu          , Re          , Re          , Uu          , Cud         , Uu          , Uu          , Uu          , Xu          , Uh          
Gg^Fet      , Gs^Fp       , Xu          , Uu^Vu       , Uu          , Cud         , 3 Kud       , Cud         , Re          , Cud         , Uu          , Uu          , Uu          , Uu          , Uu          , Uu          , Xu          , Xu          , Xu          , Uu          , Xu          , Hh          , Xu          , Uu          , Uu          , Cud         , 1 Kud       , Cud         , Ww          , Uu          , Uu^Vud      , Xu          
Qlf         , Xu          , Uu          , Uu          , Uu          , Cud         , Cud         , Cud         , Uu          , Cud         , Uu          , Uu          , Uu^Vud      , Uu          , Uu          , Uh          , Xu          , Ql          , Ql          , Xu          , Gs^Fp       , Hh          , Xu          , Uu          , Ww          , Cud         , Cud         , Cud         , Uu          , Uu          , Ww          , Ww          
Ql          , Xu          , Xu          , Uu          , Uu          , Uu          , Uu          , Uu^Uf       , Uu^Uf       , Uu          , Uu          , Xu          , Xu          , Uh          , Uh          , Uu          , Uh          , Xu          , Ql          , Qlf         , Ggf         , Gs^Fp       , Ww          , Xu          , Xu          , Ww          , Uu          , Uu          , Ww          , Uu          , Uu          , Uu          
Ql          , Ql          , Ql          , Xu          , Uu^Vud      , Uu          , Uu^Uf       , Uu^Uf       , Uu^Uf       , Xu          , Xu          , Xu          , Qlf         , Xu          , Uh          , Uh          , Xu          , Xu          , Ql          , Qlf         , Qlf         , Ggf         , Xu          , Xu          , Uu^Vu       , Uu          , Uu          , Ww          , Ww          , Xu          , Xu          , Xu          
Qxu         , Qxu         , Qxu         , Xu          , Xu          , Xu          , Xu          , Xu          , Xu          , Xu          , Ql          , Ql          , Ql          , Xu          , Xu          , Xu          , Ql          , Ql          , Ql          , Ql          , Ql          , Qlf         , Xu          , Ww          , Uu          , Uu          , Ww          , Uu          , Xu          , Xu          , Ql          , Ql          
Qxu         , Qxu         , Qxu         , Qxu         , Qxu         , Qxu         , Qxu         , Qxu         , Qxu         , Qxu         , Qxu         , Qxu         , Qxu         , Qxu         , Qxu         , Qxu         , Xu          , Xu          , Xu          , Xu          , Xu          , Xu          , Uu          , Uu          , Ww          , Uu          , Uu          , Ww          , Xu          , Ql          , Qxu         , Qxu         
